#################################
#o.............................o#
#.######.##.###   ###.##.######.#
 .#    #.##.#M  M  M#.##.#    #. 
 .######.##.#########.##.######. 
#o.........{................##.o#
#o.............................o#
#################################