##########################
#........................#
#.######.###  ###.######.#
 .#    #.# M    #.#    #. 
 .######.########.######. 
#o...........MM.}....M..o#
#o......................o#
##########################