###############################
#o..........M................o#
#o...........................o#
#o........           ........o#
#o........ ###   ### ........o# 
 o........ #   M   # ........o<
#o........ ######### ........o#
#o........           ........o#
#o...........................o#
#o...........................o#
###############################